                                        
 ##############                     
     #        #                       
     #        #     
     #        #       
     #        #                    
     #######  # 
              ####$
